######################################
#....................................#
#.....T..............................#
#....................................#
#....................................#
#...................................#
#....................................#
#....................................#
#................@...................#
#....................................#
#....................................#
#....................................#
#....................................#
#....................................#
#....................................#
#....................................#
#....................................#
######################################
