####################
#..................#
#.....T............#
#..................#
#..................#
#..................#
#..................#
#..................#
#..................#
#..................#
#..................#
#..................#
#..................#
#......@...........#
#..................#
#..................#
#..................#
####################
